1144111111111
0002202200000
0000000000000
0000000000000
0000000000000
0000000000000
0000000000000
0000000000000
0000000000000