0122334411220
0122334411220
0433221144330
0433221144330
0000000000000
0000000000000
0000000000000
0000000000000