0110134411220
0100334411220
0000000000000
0000000000000
0000000000000
0000000000000
0000000000000
0000000000000
0000000000000
