1231231231231
1001001001001
1001001001001
0000000000000
0000000000000
0000000000000
0000000000000
0000000000000

