0120000000110
0000000000020
0000000000020
0000000000000
0000000000000
0000000000000
0000000000000
0000000000000
0000000000000