0112233441120
0112233441120
0224411332210
0224411332210
0000000000000
0000000000000
0000000000000
0000000000000
0000000000000
