0132033400130
0240012100240
0000020000000
0000000000000
0000000000000
0000000000000
0000000000000
0000000000000