1122122121223
0003303300000
0000000000000
0000000000000
0000000000000
0000000000000
0000000000000
0000000000000
0000000000000