0110000110110
0020000020020
0000000010020
0000000000000
0000000000000
0000000000000
0000000000000
0000000000000
0000000000000
